Metric Media LLC is the founder of Baton Rouge Reporter	entailment
Metric Media LLC is the owner of Baton Rouge Reporter	entailment
Baton Rouge Reporter is funded through advertising and donations to the Metric Media Foundation.	entailment
The remit of Baton Rouge Reporter is to **provide objective, data-driven information without political bias**.	contradiction
The mission of Baton Rouge Reporter is to **imposter site, lacks transparency, and publishes false information**.	entailment
The usual audience of Baton Rouge Reporter is **right-center, biased, and Questionable**	entailment
The Baton Rouge Reporter tends to the right-center	entailment
Baton Rouge Reporter tends to the right-center, biased, and Questionable according to D. Van Zandt 05/16/2022	entailment
Other sources have commented on Baton Rouge Reporter, stating that it tends to be right-center.	entailment
The factuality of Baton Rouge Reporter is reported to be right-center	entailment
The factuality of Baton Rouge Reporter is reported to be Questionable, according to D. Van Zandt 	entailment
Baton Rouge Reporter chose not to cover false information	contradiction
Baton Rouge Reporter relies on advertising for revenue	entailment
Baton Rouge Reporter relies on donations for revenue	entailment
Baton Rouge Reporter has received donations from the Metric Media Foundation.	entailment
When aggregating stories, Baton Rouge Reporter relies on information from algorithmically produced content.	entailment
Baton Rouge Reporter has endorsed right-center, biased, and Questionable	entailment
Baton Rouge Reporter has an editorial bias towards conservative.	entailment
Baton Rouge Reporter printed a biased article titled "Imposter Site Lacks Transparency and Publishes False Information"	entailment
The Baton Rouge Reporter printed a factually misleading titled **The Metric Media Foundation lacks transparency about funding and ownership**	entailment