Bradley Cameron founded NW Iowa News	entailment
NW Iowa News leads NW Iowa News	contradiction
Metric Media Foundation owns NW Iowa News	entailment
Metric Media LLC bought NW Iowa News	entailment
NW Iowa News is funded through advertising and donations to the Metric Media Foundation.	entailment
The remit of NW Iowa News is to **publish false information, lacking transparency, and to serve a conservative-leaning agenda.**	entailment
The mission of NW Iowa News is to **fill the void in community news after years of decline in local reporting by legacy media**.	contradiction
The usual audience of NW Iowa News is **conservative-leaning**.	entailment
NW Iowa News tends to the right-center, biased, and Questionable.	entailment
Other sources have commented on NW Iowa News, stating that it tends to be **right-center**	contradiction
The factuality of NW Iowa News is reported to be Questionable	entailment
The factuality of NW Iowa News is reported to be **questionable**, according to **Media Bias/Fact Check**.	entailment
NW Iowa News failed a fact-check for an article titled "Imposter Site Lacks Transparency and Publishes False Information"	entailment
NW Iowa News printed a retraction after failing a fact-check for an article titled **"Imposter Site Lacks Transparency and Publishes False Information."**	entailment
NW Iowa News chose not to cover objective, data-driven information without political bias	entailment
NW Iowa News relies on advertising for revenue	entailment
NW Iowa News relies on donations for revenue	entailment
NW Iowa News has received donations from the Metric Media Foundation.	entailment
When aggregating stories, NW Iowa News relies on information from **algorithmically produced content**	entailment
NW Iowa News has endorsed **conservative-leaning news websites**	entailment
NW Iowa News has an editorial bias towards right-center.	entailment
NW Iowa News printed a biased article titled **An Imposer Site with False Information**	entailment
NW Iowa News printed a factually misleading titled "Metric Media: Bringing Objective News to Your Community"	entailment
NW Iowa News is a **conservative news and opinion website**	entailment
NW Iowa News covers the following topics:  conservative-leaning news.	entailment