Newsquest leads Border Telegraph	entailment
Newsquest Media Group Ltd owns Border Telegraph	entailment
Newsquest Media Group Ltd is the owner of Border Telegraph	entailment
Border Telegraph is funded through advertising and subscription fees.	entailment
The remit of Border Telegraph is to cover local news for the Glashiels area.	entailment
The mission of Border Telegraph is to ***cover local news for the Glashiels area through reporters with minimal bias***.	entailment
Other sources have commented on Border Telegraph, stating that it tends to be least biased.	entailment
The factuality of Border Telegraph is reported to be High	entailment
The factuality of Border Telegraph is reported to be High, according to Mediabiasfactcheck.com	entailment
Border Telegraph failed a fact-check for an article titled "Hawick: Road closures ahead of Christmas lights switch-on"	contradiction
Border Telegraph chose not to cover national and international news.	contradiction
Border Telegraph provides original content written by staff journalists	entailment
Border Telegraph relies on advertising for revenue	entailment
Border Telegraph relies on subscriptions for revenue	entailment
Border Telegraph relies on donations for revenue	contradiction
When aggregating stories, Border Telegraph relies on information from **first-person accounts and large quotes**.	entailment
Border Telegraph has endorsed least biased	entailment
Border Telegraph has an editorial bias towards least biased.	entailment
Border Telegraph's headquarter is located in Galashiels	entailment
Border Telegraph is a newspaper	entailment
Border Telegraph covers the following topics: news and politics, lifestyle and culture, and local events and news related to the Galashiels area	entailment