Metric Media LLC founded Central Idaho Times	entailment
Metric Media Foundation owns Central Idaho Times	entailment
Metric Media LLC is the owner of Central Idaho Times	contradiction
Central Idaho Times is funded through advertising and donations to the Metric Media Foundation.	entailment
The remit of Central Idaho Times is to **mislead the public**	entailment
The mission of Central Idaho Times is to  provide objective, data-driven information without political bias.	contradiction
The usual audience of Central Idaho Times is right-center and Questionable	entailment
The Central Idaho Times tends to the right-center bias	entailment
Other sources have commented on Central Idaho Times, stating that it tends to be right-center biased.	entailment
The factuality of Central Idaho Times is reported to be Questionable	entailment
The factuality of Central Idaho Times is reported to be **questionable**, according to **Media Bias Fact Check**.	entailment
Central Idaho Times failed a fact-check for an article titled "Imposter Site Lacks Transparency and Publishes False Information"	entailment
Central Idaho Times chose not to cover imposter site, lacks transparency, and publishes false information.	entailment
Central Idaho Times provides original content written by staff journalists	contradiction
Central Idaho Times relies on advertising for revenue	entailment
Central Idaho Times relies on subscriptions for revenue	contradiction
Central Idaho Times relies on donations for revenue	entailment
When aggregating stories, Central Idaho Times relies on information from **algorithmically produced content**.	entailment
Central Idaho Times has an editorial bias towards **right-center**	entailment
Central Idaho Times printed a biased article titled **Imposter Site**	entailment
Central Idaho Times printed a factually misleading titled is an imposter site	entailment
Central Idaho Times is funded by the **Metric Media Foundation** government	contradiction
Central Idaho Times is a imposter site	entailment
Central Idaho Times covers the following topics: conservative-leaning news	entailment